F 34,252,55
EA assets/eagle.xpm
WE assets/purplestone.xpm
C 54,55,56
SO 					     assets/greystone.xpm


							NO assets/red.xpm


11111011
100110011100111
1100N1
111111
