NO assets/anorth.xpm
SO assets/asouth.xpm
EA assets/aeast.xpm
WE assets/awest.xpm
C 47,71,90
F 31,33,47

    111
1111101
1000001
1000S01
1000011
111111
