NO assets/eagle.xpm
SO assets/greystone.xpm
WE assets/purplestone.xpm
EA assets/red.xpm

F 34,252,55
C 2,54,55,56

111111
100101
101001
1100N1
111111
