NO assets/eagle.xpm
SO assets/greystone.xpm
WE assets/purplestone.xpm
EA assets/red.xpm

F 34,252,55
C 54,55,56

11111111
1001000111
    10111
1100N1
111111
