NO assets/eagle.xpm
SO assets/greystone.xpm
WE assets/purplestone.xpm
EA assets/red.xpm
         F 100,100,100
                  C 135,206,235

             1
            101
            101
        1111101
111111111110101111101111
100000000000000111111111
100000000000000000000001
100000000000000000000001
100000111110000100110001
100000100010000000000001
100000100010000100010001
100000100010000000000001111111111
1000001101100001010100000000000001
1000000000000000000000000000000001
100000000000000000000011111111111
10000000000000000000001
100000000000000000000001
1000000000000N0000000001
100000000000000000000001
11111000000000000000000011111111
    11111000000000000001
11111000010000000000000011111111
110000001000000000000001
110100001000000000000001
110111111000000000000001
110000000000000000000001
111111100000000000000001
111111100111111111111111
       101
       101
       101
    11110111111
    100000000001
    10111111011
    101    101
     1     1001
          100001
         10000001
        1000000001
       100000000001111111111111111111111111111111111111
      10000000000000000000000000000000000000000000000001
      10000000000000000000000000000000000000000000000001
      10000000000000000000000000000000000000000000000001
      10000000000000000000000000000000000000000000000001
      10000000000000000000000000000000000000000000000001
      10000000000000000000000000000000000000000000000001      10000000000000000000000000000000000000000000000001
      10000000000000000000000000000000000000000000000001      10000000000000000000000000000000000000000000000001
      10000000000000000000000000000000000000000000000001      10000000000000000000000000000000000000000000000001
      10000000000000000000000000000000000000000000000001      10000000000000000000000000000000000000000000000001
      10000000000000000000000000000000000000000000000001      10000000000000000000000000000000000000000000000001
      10000000000000000000000000000000000000000000000001      10000000000000000000000000000000000000000000000001
      10000000000000000000000000000000000000000000000001      10000000000000000000000000000000000000000000000001
      10000000000000000000000000000000000000000000000001      10000000000000000000000000000000000000000000000001
      10000000000000000000000000000000000000000000000001      10000000000000000000000000000000000000000000000001
      10000000000000000000000000000000000000000000000001      10000000000000000000000000000000000000000000000001
      10000000000000000000000000000000000000000000000001      10000000000000000000000000000000000000000000000001
      10000000000000000000000000000000000000000000000001      10000000000000000000000000000000000000000000000001
      10000000000000000000000000000000000000000000000001      10000000000000000000000000000000000000000000000001
      10000000000000000000000000000000000000000000000001      10000000000000000000000000000000000000000000000001
      10000000000000000000000000000000000000000000000001      10000000000000000000000000000000000000000000000001
      10000000000000000000000000000000000000000000000001      10000000000000000000000000000000000000000000000001
      10000000000000000000000000000000000000000000000001      10000000000000000000000000000000000000000000000001
      10000000000000000000000000000000000000000000000001      10000000000000000000000000000000000000000000000001
      10000000000000000000000000000000000000000000000001      10000000000000000000000000000000000000000000000001
      10000000000000000000000000000000000000000000000001      10000000000000000000000000000000000000000000000001
      10000000000000000000000000000000000000000000000001      10000000000000000000000000000000000000000000000001
      10000000000000000000000000000000000000000000000001      10000000000000000000000000000000000000000000000001
      10000000000000000000000000000000000000000000000001      10000000000000000000000000000000000000000000000001
      10000000000000000000000000000000000000000000000001      10000000000000000000000000000000000000000000000001
      10000000000000000000000000000000000000000000000001      10000000000000000000000000000000000000000000000001
      10000000000000000000000000000000000000000000000001      10000000000000000000000000000000000000000000000001
      10000000000000000000000000000000000000000000000001      10000000000000000000000000000000000000000000000001
      10000000000000000000000000000000000000000000000001      10000000000000000000000000000000000000000000000001
      10000000000000000000000000000000000000000000000001      10000000000000000000000000000000000000000000000001
      10000000000000000000000000000000000000000000000001      10000000000000000000000000000000000000000000000001
      10000000000000000000000000000000000000000000000001      10000000000000000000000000000000000000000000000001
      10000000000000000000000000000000000000000000000001      10000000000000000000000000000000000000000000000001
      10000000000000000000000000000000000000000000000001      10000000000000000000000000000000000000000000000001
      10000000000000000000000000000000000000000000000001      10000000000000000000000000000000000000000000000001
      10000000000000000000000000000000000000000000000001      10000000000000000000000000000000000000000000000001
      10000000000000000000000000000000000000000000000001      10000000000000000000000000000000000000000000000001
      10000000000000000000000000000000000000000000000001      10000000000000000000000000000000000000000000000001
      10000000000000000000000000000000000000000000000001      10000000000000000000000000000000000000000000000001
      10000000000000000000000000000000000000000000000001      10000000000000000000000000000000000000000000000001
      10000000000000000000000000000000000000000000000001      10000000000000000000000000000000000000000000000001
      10000000000000000000000000000000000000000000000001      10000000000000000000000000000000000000000000000001
      10000000000000000000000000000000000000000000000001      10000000000000000000000000000000000000000000000001
      10000000000000000000000000000000000000000000000001      10000000000000000000000000000000000000000000000001
      10000000000000000000000000000000000000000000000001      10000000000000000000000000000000000000000000000001
      10000000000000000000000000000000000000000000000001
1111111111111111111111111111111111111111111111111111111111
